

NO ./NO.xpm

SO SO.xpm

WE WE.xpm

EA EA.xpm

F 144,122,37
C 44,231,238

11111111111111111111
100E0000000000000001
10000000100000000001
10000000000000000001
11111111111111111111