

NO ./NO.xpm

SO SO.xpm

WE WE.xpm

EA EA.xpm

F 144,122,37
C 44,231,238

11111111111111111111
1000D0001100000000001
100DED00000D000000001
1000D001100100000001
11111111111 11111111