

NO ./NO.xpm

SO SO.xpm

WE WE.xpm

EA EA.xpm

F 144,122,37
C 44,231,238

11111111111111111111
100000001100000000001
1000E00000000000000001
100000011001000000011
11111111111 11111111