NO ./texture/NO.xpm

SO ./texture/SO.xpm

WE ./texture/WE.xpm

EA ./texture/EA.xpm

F 144,122,37
C 44,231,238

11111111111111111111111111111111111111111
11111111111000001000001000101000001000001
11101110101111111010111110101010111011111
100010000S0010000010100010000010100000001
10111111111011101010101111111110111111101
10100000001000001010000010000010001010001
11101010111110111011111010111111101010101
10001010100000100000001010100000100010101
11111111111111111111111111111111111111111