NO NO.xpm

SO SO.xpm

WE WE.xpm

EA EA.xpm

F 144,122,37
C 44,231,238

11111111111111111111111111111111111111111
100000000001111111000000000000000001
1000S00000010000000001000000011111111
10000000000100000000010000001     1  
1000000010010000000001111000011111111
1000000010010000000001000110001111
10000001011101100000000000000001
10000000000000000000000000000001
11111111111111111111111111111111111111111