NO ./texture/NO.xpm

SO ./texture/SO.xpm

WE ./texture/WE.xpm

EA ./texture/EA.xpm

F 144,122,37
C 44,231,238

11111111111111111111111111111111111111111
10000S00000111111100000000000000000000001
10000000000100000000010000000000000000001
10000000000100000000010000000000000000001
10000000100100000000011110000000000000001
10000000100100000000010001100011100000001
10000001111111100000010000000000000000001
10000000000000000000000000000000000000001
11111111111111111111111111111111111111111