NO NO.xpm

SO SO.xpm

WE      WE.xpm

EA EA.xpm

F         0,122,37
C         255,69,33

       1111 11111111111111111111111111
11111110000110000100000001111111
1011000001110000100000001111111
1001000000000000000000001111111
1111111110110000011100001111111
1000000000110000011101111111111
1111011111111101110000101000111
1111011111111101110101101000111
1100000011010101110100001000001
10000000000000N0100000001000111
1111111111111111 11111111111111
